10 7 70
w f f p w w f f f w
f f b b f f f f f w
f f f b b w t t f w
f f b b f w t t f f
f f f w f w t t f f
f f f f f w w w w w
w f f w w w w w w w
