10 10 90
w p f f f f f f f w
t w f f f f f f w t
f f w f f f f w f f
f f f b f f b f f f
f f f f w w f f f f
f f f b f f b f f f
f f f f f f f f f f
f f w f f f f w f f
t w f f f f f f w t
w f f f f f f f f w
