15
13
111111111111111
103333333333341
131311121113131
133310000013331
131311121113131
133333333333331
141313131313141
133333333333331
131111141111131
131313131313131
131313131313131
143333333333341
111111111111111